1,1,1,1,1,1,1,1,1,1,1,1,1,1,1,1,1,1,1,1,1,1,1,1
11,0,0,0,0,0,0,0,0,0,0,0,0,0,0,0,0,0,0,0,0,0,0,6
1,0,0,0,0,0,7,6,0,0,0,0,0,0,0,0,0,3,0,0,0,0,0,7
1,0,0,7,0,0,0,0,0,0,0,0,0,0,0,0,0,0,0,0,0,0,0,6
1,0,0,6,0,0,2,2,2,2,2,0,0,0,0,3,0,3,0,3,0,0,0,7
1,0,0,0,0,0,2,0,0,0,2,0,0,0,0,0,0,0,0,0,0,0,0,6
1,0,0,0,0,0,2,0,0,0,2,0,0,3,0,3,0,0,0,3,0,3,0,7
1,0,0,0,0,0,2,0,0,0,2,0,0,0,0,0,0,0,0,0,0,0,0,6
1,0,0,0,0,0,2,2,0,2,2,0,0,0,0,3,0,3,0,3,0,0,0,7
1,0,0,0,0,0,0,0,0,0,0,0,0,0,0,0,0,0,0,0,0,0,0,6
1,0,0,0,0,0,0,0,0,0,0,0,0,0,0,0,0,3,0,0,0,0,0,14
1,0,0,0,3,3,3,0,0,0,0,0,0,0,0,0,0,0,0,0,0,0,0,14
1,0,0,0,0,0,0,0,0,0,14,0,0,0,0,0,0,0,0,0,0,0,0,14
1,0,0,0,3,3,3,0,0,0,0,0,0,0,0,0,0,0,0,0,0,0,0,14
1,0,0,0,0,0,0,0,0,0,0,0,0,0,0,0,0,0,0,0,0,0,0,14
1,0,0,0,0,0,0,0,0,0,0,0,0,0,0,0,0,14,0,0,0,0,0,14
1,4,4,4,4,4,4,4,4,0,0,0,14,0,0,0,0,14,0,0,0,0,0,12
1,4,0,4,0,0,0,0,4,0,0,0,0,0,0,0,0,14,0,0,14,0,0,12
1,4,0,0,0,0,5,0,4,0,0,0,0,0,0,0,0,0,14,14,0,0,0,12
1,4,0,4,0,0,0,0,4,0,0,4,0,0,0,0,0,0,14,0,0,0,0,12
1,4,0,4,4,4,4,4,4,0,0,4,0,0,0,0,0,0,0,0,0,0,0,12
1,4,0,0,0,0,0,0,0,0,0,4,0,0,0,0,0,0,0,0,0,0,0,12
1,4,4,4,4,4,4,4,4,4,4,4,0,0,0,0,0,0,0,0,0,0,0,12
1,1,1,1,1,1,1,1,1,1,1,12,12,12,12,12,12,12,13,12,12,12,12,12