1 1 1 1 3 4 1 1 4 1 1 4 1 1 3 1 1 1 1 1
1 0 3 0 0 0 0 0 0 0 0 0 0 0 0 0 0 0 6 1
1 0 2 0 0 0 0 0 0 0 0 0 0 0 0 0 0 0 3 1
4 0 3 0 0 0 6 6 0 0 6 6 0 0 6 6 0 0 6 1
1 0 4 0 0 0 6 6 0 0 6 6 0 0 6 6 0 0 3 1
1 0 3 0 0 0 0 0 0 0 0 0 0 0 0 0 0 0 7 1
4 0 4 0 0 0 0 0 0 0 0 0 0 0 0 0 0 0 7 1
1 0 2 0 0 0 6 6 0 0 6 6 0 0 6 6 0 0 3 1
4 0 2 0 0 0 6 6 0 0 6 6 0 0 6 6 0 0 6 1
1 0 3 0 0 0 0 0 0 0 0 0 0 0 0 0 0 0 3 1
1 0 3 3 0 0 3 3 3 12 0 0 0 0 0 12 0 0 0 1
1 0 0 0 0 0 3 7 7 12 0 0 12 0 0 12 0 0 0 1
1 7 3 2 3 3 3 0 0 12 0 0 12 0 0 12 0 0 0 1
1 6 6 6 6 6 6 0 0 12 0 0 12 7 7 12 0 0 0 1
6 5 0 0 6 0 0 0 0 12 0 0 12 12 12 12 8 8 8 1
6 3 0 0 7 0 0 0 2 2 0 0 0 0 0 0 0 0 8 1
6 0 0 6 6 0 0 0 2 0 0 0 0 0 0 0 0 8 8 1
6 0 6 0 0 0 0 0 2 0 0 0 0 0 0 0 9 8 9 1
1 0 3 0 0 0 0 2 2 0 2 2 0 2 2 0 0 0 10 1
1 0 3 0 3 0 0 2 2 0 2 2 0 2 2 0 9 8 9 1
1 0 2 0 2 0 0 0 0 0 0 0 0 0 0 0 9 8 9 1
1 0 3 0 4 0 0 0 8 9 0 9 0 9 0 0 0 0 10 1
1 0 3 0 3 0 0 0 8 8 0 8 0 8 8 8 9 8 9 1
1 0 0 0 2 7 6 7 8 9 10 9 10 9 0 0 8 0 0 1
1 1 1 1 1 1 1 1 1 1 1 1 1 1 1 1 1 1 1 1