6 7 6 7 6 7 6 7 6 7 6 7 6 7 6 7 6 7 6 6 6 6 6 6
7 0 0 0 0 0 0 0 0 0 0 0 0 0 0 0 0 0 0 0 0 0 0 6
6 0 0 0 0 0 0 0 0 0 0 0 0 0 0 0 0 0 0 0 1 0 0 6
7 0 0 0 0 6 6 6 0 0 3 3 3 0 0 3 3 3 1 0 1 0 0 6
6 6 0 0 0 6 0 0 0 0 3 0 0 0 0 0 0 0 1 0 2 0 0 6
6 6 7 7 6 6 0 0 0 0 3 0 0 0 0 0 0 0 1 0 2 0 0 7
6 0 0 0 0 0 0 6 0 0 3 0 3 3 0 3 3 0 1 0 0 0 0 7
6 0 0 0 0 0 0 6 0 0 3 0 3 3 0 3 3 0 1 0 0 0 0 6
6 0 0 0 2 2 0 6 0 0 3 0 0 0 0 0 0 0 1 0 1 0 0 7
6 0 0 0 2 2 0 6 0 0 3 2 2 2 2 2 2 2 2 0 2 0 0 7
7 0 0 0 0 0 0 6 0 0 0 0 0 0 0 0 0 0 0 0 1 0 0 6
7 0 0 0 0 0 0 6 0 0 3 0 2 0 2 0 2 0 2 0 2 0 0 7
6 0 0 0 2 2 0 6 0 0 3 0 2 0 2 0 2 0 2 0 1 0 0 7
6 0 0 0 2 2 0 0 0 3 3 2 2 2 2 2 2 0 2 2 1 0 0 6
7 0 0 0 0 0 0 0 0 0 0 6 3 0 0 0 0 0 0 0 2 0 3 6
7 0 0 0 0 0 0 0 0 0 0 6 3 0 0 0 0 0 0 0 0 0 0 7
6 0 0 0 2 2 0 0 0 0 0 6 0 0 0 0 0 1 1 0 0 0 0 7
6 0 0 0 2 2 0 6 0 0 0 0 0 0 1 1 0 1 1 0 0 0 0 6
7 0 0 0 0 0 0 6 0 0 0 0 0 0 1 1 0 0 0 0 0 0 0 6
7 0 0 0 0 0 0 6 0 7 0 6 0 0 0 0 0 0 0 1 1 0 0 6
6 0 0 0 2 2 0 6 0 7 0 6 0 0 0 0 1 1 0 1 1 0 7 6
6 0 0 0 2 2 0 6 0 7 0 6 6 6 0 0 1 1 0 0 0 0 7 6
6 0 0 0 0 0 0 6 0 7 0 0 0 6 0 0 0 0 0 0 0 0 0 6
6 0 0 0 0 0 0 6 0 7 0 0 0 6 0 0 0 0 0 7 7 0 0 6
6 6 6 6 6 6 6 6 6 6 6 6 5 6 6 6 6 6 6 6 6 6 6 6