1 1 1 1 1 1 1 1 1 1 1 1 1 1 1 1 1 1 1 1
11 0 0 0 0 3 3 3 1 1 1 1 1 1 1 1 1 1 1 1
1 0 0 0 0 0 0 0 0 0 0 0 0 0 0 0 0 0 1 1
1 0 1 1 1 0 0 0 0 0 0 0 0 0 0 0 0 0 1 1
1 0 0 1 1 0 0 0 0 3 3 3 3 0 0 0 0 0 1 1
1 1 0 1 1 0 0 0 0 3 3 3 3 0 0 0 0 0 1 1
6 6 0 6 1 0 0 0 0 0 0 0 0 0 4 4 0 0 1 1
5 0 0 6 1 0 0 0 0 0 0 0 7 6 1 1 0 0 1 1
6 6 7 6 1 1 1 1 1 0 0 0 6 0 0 0 0 6 1 1
1 1 2 2 2 2 2 2 2 0 0 0 1 1 0 0 0 6 1 1
1 1 0 0 0 0 0 0 0 0 0 6 6 6 0 0 0 0 1 1
1 1 0 7 7 0 0 6 0 0 6 6 7 6 0 0 0 0 1 1
1 1 0 7 7 0 0 6 6 6 6 0 0 6 0 0 0 0 1 1
1 1 0 0 0 0 0 0 0 0 6 6 0 6 0 0 0 0 1 1
1 1 0 0 0 0 0 0 0 0 6 0 0 6 0 0 0 0 1 1
1 1 0 0 0 4 4 0 0 0 0 0 0 0 0 1 1 0 1 1
1 1 0 0 0 4 4 0 0 0 0 0 0 0 0 1 1 0 2 2
1 1 0 0 0 1 1 0 0 0 0 0 0 0 0 0 0 0 2 2
1 1 1 1 1 1 1 3 3 3 3 3 3 3 3 3 1 1 1 1
1 1 1 1 1 1 1 1 1 1 1 1 1 1 1 1 1 1 1 1